border_size=1
usage=map

Md          , Md          , Md          , Md          , Hd          , Md          , Hd          , Md          , Hd          , Hd          , Gs^Fdw      , Gg          , Hh^Fms      , Gg          , Hh^Fms      , Ww          , Hh^Fdw      , Hh^Fdw      , Hh^Fmw      , Hh^Fdw      , Hh^Fmw      , Ww          , Hh^Fms      , Gg          , Hh^Fms      , Hh^Fds      , Gs^Fdw      , Hd          , Hd          , Md          , Md          , Md          , Md          , Md          , Md          , Md          
Md          , Md          , Hd          , Hd          , Ds          , Hd          , Ds          , Hd          , Ds          , Hd          , Gs^Fdw      , Hh^Fms      , Hh^Fds      , Hh^Fms      , Hh^Fms      , Ww          , Hh^Fdw      , Hh^Fdw      , Hh^Fmw      , Hh^Fmw      , Hh^Fmw      , Ww          , Hh^Fds      , Hh^Fms      , Hh^Fds      , Hh^Fms      , Gs^Fdw      , Hd          , Ds          , Hd          , Ds          , Hd          , Hd          , Md          , Md          , Md          
Md          , Hd          , Ds          , Ds          , Ds          , Ds          , Ds          , Ds          , Dd^Vdt      , Ds          , Gs^Fdw      , Hh^Fds      , Ww          , Hh^Fms      , Ww          , Ww          , Ww          , Hh^Fdw      , Hh^Fdw      , Hh^Fmw      , Ww          , Ww          , Ww          , Hh^Fds      , Ww          , Hh^Fds      , Gs^Fdw      , Ds          , Dd^Vdt      , Ds          , Ds          , Dd^Dc       , Ds          , Hd          , Hd          , Md          
Md          , Hd          , Ds          , Ds          , 6 Ke        , Ce          , Ce          , Ds          , Ds          , Ds          , Ds          , Gs^Fdw      , Gs^Fdw      , Ww          , Gs^Fdw      , Gs^Fdw      , Gs^Fdw      , Ww          , Ww          , Ww          , Gs^Fdw      , Gs^Fdw      , Gs^Fdw      , Ww          , Gs^Fdw      , Gs^Fdw      , Ds          , Ds          , Ds          , Ds          , Ce          , Ds          , Ds          , Ds          , Hd          , Md          
Md          , Hd          , Ds          , Ce          , Ce          , Ce          , Ce          , Ce          , Ds          , Ds          , Ds          , Ds          , Ds          , Gs^Fdw      , Ds          , Ds          , Ds          , Gs^Fdw      , Gs^Fdw      , Gs^Fdw      , Ds          , Ds          , Ds          , Gs^Fdw      , Ds          , Ds          , Ds          , Dd          , Ce          , Ce          , Ce          , 5 Ke        , Ce          , Ds          , Hd          , Md          
Ds          , Hd          , Ds          , Ds          , Ds          , Ce          , Rd          , Ds          , Rd          , Rd          , Rd          , Ds          , Ds          , Ds          , Ds          , Ds          , Ds          , Ds          , Ds          , Ds          , Ds          , Ds          , Ds          , Ds          , Rd          , Rd          , Rd          , Ds          , Ds          , Ce          , Ce          , Ce          , Ds          , Ds          , Hd          , Md          
Rd          , Ds          , Ds          , Ds          , Ds          , Ds          , Rd          , Rd          , Ds          , Ds          , Ds          , Rd          , Rd          , Ds          , Ds          , Ds          , Ds          , Ds          , Ds          , Ds          , Ds          , Ds          , Rd          , Rd          , Ds          , Ds          , Ds          , Rd          , Rd          , Rd          , Ds          , Ds          , Ds          , Ds          , Ds          , Dd^Dc       
Ds          , Rd          , Rd          , Ds          , Rd          , Rd          , Dd^Vda      , Ds          , Dd          , Dd^Vdt      , Dd^Dc       , Ds          , Ds          , Rd          , Rd          , Ds          , Ds          , Dd          , Ds          , Ds          , Rd          , Rd          , Ds          , Ds          , Dd^Dc       , Dd^Vdt      , Dd          , Ds          , Ds          , Rd          , Rd          , Ds          , Ds          , Ds          , Rd          , Rd          
Md          , Ds          , Ds          , Rd          , Rd          , Ds          , Ds          , Ds          , Ds          , Dd^Do       , Hd          , Hd          , Md          , Ds          , Ds          , Rd          , Rd          , Ds          , Rd          , Rd          , Ds          , Ds          , Md          , Hd          , Hd          , Dd^Do       , Ds          , Ds          , Ds          , Dd^Vda      , Ds          , Rd          , Rd          , Rd          , Ds          , Ds          
Hh          , Md          , Md          , Ds          , Ds          , Rd          , Rd          , Ds          , Ds          , Hd          , Md          , Md          , Uh          , Md          , Md          , Ds          , Rd          , Rd          , Rd          , Ds          , Md          , Md          , Uh          , Md          , Md          , Hd          , Hd          , Ds          , Ds          , Ds          , Rd          , Rd          , Ds          , Ds          , Md          , Md          
Ds          , Hh          , Hh          , Md          , Md          , Ds          , Ds          , Rd          , Ds          , Md          , Uh          , Uh          , Uu^Uf       , Uh          , Uh          , Uh          , Rp          , Rp          , Rp          , Rp          , Uh          , Uh          , Uu          , Uh          , Uh          , Md          , Md          , Ds          , Rd          , Rd          , Ds          , Ds          , Md          , Md          , Hh          , Hh          
Ss          , Ds          , Ds          , Hh          , Hh          , Md          , Re          , Rd          , Ds          , Md          , Uh          , Uu          , Ur          , Ur          , Gs^Fp       , Gs^Fp       , Ww^Bw|      , Hh^Fp       , Ww          , Rp          , Gs^Fp       , Ur          , Ur          , Uu^Uf       , Uu          , Uh          , Md          , Ds          , Rd          , Ds          , Md          , Md          , Hh          , Hh          , Ds          , Ds          
Ww          , Ss          , Ss          , Ds          , Ds          , Hh          , Re          , Rp          , Rp          , Rd          , Uh          , Ur          , Wo          , Wo          , Ww          , Wwf         , Ww^Bw|      , Ww          , Ww          , Ww^Bw|      , Ss          , Wo          , Wo          , Ur          , Ur          , Uh          , Rd          , Ds          , Rp          , Re          , Hh          , Hh          , Ds          , Ds          , Ss          , Ss          
Wwr         , Ww          , Ww          , Ss          , Ss^Bw|      , Ss^Bw/      , Ds          , Ggf         , Re          , Rp          , Rp          , Gs^Fp       , Ss          , Ww          , Ww          , Wwf         , Rr          , Ww          , Mm          , Ww^Bw|      , Ss^Vhs      , Ww          , Ww          , Wo          , Gs^Fp       , Uh          , Rp          , Rp          , Ggf         , Re          , Ss^Bw\      , Ds          , Ss          , Ss          , Ww          , Ww          
Wwr         , Ww          , Ww          , Ss          , Ww^Bw\      , Ss          , Ss          , Ds          , Ss^Bw|      , Uh          , Gs^Fp       , Ww^Bw\      , Ww^Bw\      , Ss^Vhs      , Hh          , Hh^Fp       , Rr          , Hh^Vhh      , Hh          , Rr          , Hh          , Ww          , Wwr         , Wwr         , Ww^Bw/      , Rp          , Uh          , Re          , Ds          , Ds          , Ss          , Ss^Bw|      , Ss          , Ww          , Ww          , Wwr         
Wwr         , Wwr         , Wwr         , Ww          , Ds          , Ww^Bw\      , Ww^Bw\      , Ss^Bw/      , Ss          , Uh          , Wwr         , Ww          , Ww          , Rr          , Rr          , Rp^Vhc      , 1 Kud       , Gs^Fp       , Gg^Ve       , Rr          , Rp^Vhc      , Hh^Fp       , Rr          , Ww^Bw/      , Wwr         , Hh^Fp       , Uh          , Ss^Bw|      , Ss^Bw\      , Ss          , Ww^Bw/      , Ww^Bw/      , Ww          , Ww          , Wwr         , Wwr         
Wwr         , Wwr         , Wwr         , Ww          , Dd^Do       , Ww          , Ww^Bw|      , Ss          , Uh          , Uh          , Wwr         , Ww          , Ww^Vm       , Mm          , Hh^Vhh      , Rr          , Cud         , Cud         , Cud         , Rr          , 2 Kud       , Rr          , Hh          , Ww^Vm       , Ww          , Wwf         , Uh          , Ss          , Ss          , Ww^Bw/      , Ww          , Ds          , Ww          , Wwr         , Wwr         , Wwr         
Wwr         , Wwr         , Ww          , Ww          , Ds          , Ww          , Ww^Bw|      , Ww          , Uh          , Uu^Uf       , Wo          , Wwr         , Wwf         , Rr          , Rr          , Gs^Fp       , Cud         , Cud         , Cud         , Cud         , Cud         , Gg^Ve       , Hh^Fp       , Ww          , Wwf         , Wwf         , Uu          , Uh          , Ww          , Ww^Bw|      , Ww          , Dd^Do       , Ww          , Wwr         , Wwr         , Wwr         
Wwr         , Wwr         , Wwr         , Ww          , Dd^Do       , Ww          , Ww^Bw|      , Ww          , Uh          , Uu          , Wwf         , Wwf         , Ww          , Hh^Fp       , Gg^Ve       , Cud         , Cud         , Cud         , Cud         , Cud         , Gs^Fp       , Rr          , Rr          , Wwf         , Wwr         , Wo          , Uu^Uf       , Uh          , Ww          , Ww^Bw|      , Ww          , Ds          , Ww          , Ww          , Wwr         , Wwr         
Wwr         , Wwr         , Wwr         , Ww          , Ds          , Ww          , Ww^Bw/      , Ss          , Ss          , Uh          , Wwf         , Ww          , Ww^Vm       , Hh          , Rr          , 4 Kud       , Rr          , Cud         , Cud         , Cud         , Rr          , Hh^Vhh      , Mm          , Ww^Vm       , Ww          , Wwr         , Uh          , Uh          , Ss          , Ww^Bw|      , Ww          , Dd^Do       , Ww          , Wwr         , Wwr         , Wwr         
Wwr         , Wwr         , Ww          , Ww          , Ww^Bw/      , Ww^Bw/      , Ss          , Ss^Bw\      , Ss^Bw|      , Uh          , Hh^Fp       , Wwr         , Ww^Bw/      , Rr          , Hh^Fp       , Rp^Vhc      , Rr          , Gg^Ve       , Gs^Fp       , 3 Kud       , Rp^Vhc      , Rr          , Rr          , Ww          , Ww          , Wwr         , Uh          , Ss          , Ss^Bw/      , Ww^Bw\      , Ww^Bw\      , Ds          , Ww          , Wwr         , Wwr         , Wwr         
Wwr         , Wwr         , Ww          , Ss          , Ss^Bw|      , Ss          , Ai          , Ai          , Re          , Uh          , Rp          , Ww^Bw/      , Wwr         , Wwr         , Ww          , Hh          , Rr          , Hh          , Hh^Vhh      , Rr          , Hh^Fp       , Hh          , Ss^Vhs      , Ww^Bw\      , Ww^Bw\      , Gs^Fp       , Uh          , Ss^Bw|      , Ai          , Ss          , Ss          , Ww^Bw|      , Ss          , Ww          , Wwr         , Wwr         
Ww          , Ww          , Ss          , Ss          , Ai          , Ss^Bw\      , Re          , Ggf         , Rp          , Rp          , Uh          , Gs^Fp       , Wo          , Ww          , Ww          , Ss^Vhs      , Ww^Bw|      , Mm          , Ww          , Rr          , Wwf         , Ww          , Ww          , Ss          , Gs^Fp       , Rp          , Rp          , Re          , Ggf         , Ai          , Ss^Bw/      , Ss^Bw/      , Ss          , Ww          , Ww          , Wwr         
Ss          , Ss          , Ai          , Ai          , Hh          , Hh          , Ggf         , Rp          , Ai          , Ai          , Uh          , Ur          , Ur          , Wo          , Wo          , Ss          , Ww^Bw|      , Ww          , Ww          , Ww^Bw|      , Wwf         , Ww          , Wo          , Wo          , Ur          , Uh          , Ai          , Rp          , Rp          , Re          , Hh          , Ai          , Ai          , Ss          , Ss          , Ww          
Ai          , Ai          , Hh          , Hh          , Ha          , Ha          , Aa          , Rr          , Ai          , Ms          , Uh          , Uu          , Uu^Uf       , Ur          , Ur          , Gs^Fp       , Rp          , Ww          , Hh^Fp       , Ww^Bw|      , Gs^Fp       , Gs^Fp       , Ur          , Ur          , Uu          , Uh          , Ms          , Ai          , Rr          , Ggf         , Ha          , Hh          , Hh          , Ai          , Ai          , Ss          
Hh          , Hh          , Ha          , Ha          , Aa          , Aa          , Rr          , Rr          , Aa          , Ms          , Ms          , Uh          , Uh          , Uu          , Uh          , Uh          , Ai          , Rp          , Rp          , Rp          , Ai          , Uh          , Uh          , Uu^Uf       , Uh          , Uh          , Ms          , Ai          , Rr          , Aa          , Aa          , Ha          , Ha          , Hh          , Hh          , Ai          
Ha          , Ha          , Aa          , Aa          , Rr          , Rr          , Aa          , Aa          , Aa          , Ha          , Ha          , Ms          , Ms          , Uh          , Ms          , Ms          , Ai          , Rp          , Rr          , Rp          , Ai          , Ms          , Ms          , Uh          , Ms          , Ms          , Ha          , Aa          , Aa          , Rr          , Rr          , Aa          , Aa          , Ha          , Ha          , Hh          
Aa          , Aa          , Rr          , Rr          , Rr          , Aa          , Aa          , Aa          , Aa          , Aa          , Aa          , Ha          , Ha          , Ms          , Ai          , Ai          , Rr          , Rr          , Aa          , Rr          , Rr          , Ai          , Ai          , Ms          , Ha          , Ha          , Aa          , Aa          , Aa          , Aa          , Aa          , Rr          , Rr          , Aa          , Aa          , Ha          
Rr          , Rr          , Aa          , Aa          , Aa^Vha      , Rr          , Rr          , Aa          , Aa          , Aa          , Aa          , Aa          , Aa          , Ai          , Rr          , Rr          , Aa          , Aa          , Aa          , Aa          , Aa          , Rr          , Rr          , Ai          , Aa          , Aa          , Aa          , Aa          , Aa          , Aa          , Rr          , Rr          , Aa          , Rr          , Rr          , Aa          
Aa          , Aa          , Aa          , Aa          , Aa          , Aa          , Aa          , Rr          , Rr          , Aa          , Aa^Voa      , Aa          , Rr          , Rr          , Aa          , Aa          , Aa          , Aa          , Aa          , Aa          , Aa          , Aa          , Aa          , Rr          , Rr          , Aa          , Aa^Voa      , Aa          , Rr          , Rr          , Aa          , Aa^Vha      , Aa          , Aa          , Aa          , Rr          
Ha          , Ha          , Aa          , Aa          , Ch          , Ch          , Ch          , Aa          , Aa          , Rr          , Rr          , Rr          , Aa          , Aa          , Aa          , Aa          , Aa          , Aa          , Aa          , Aa          , Aa          , Aa          , Aa          , Aa          , Aa          , Rr          , Rr          , Rr          , Aa          , Aa          , Ch          , Aa          , Aa          , Aa          , Ha          , Aa          
Ha          , Ha          , Aa          , Ch          , Ch          , Ch          , Rr          , Aa          , Rr          , Rr          , Aa          , Aa          , Aa          , Aa          , Aa          , Aa          , Aa          , Aa          , Aa          , Aa          , Aa^Fpa      , Aa          , Aa          , Aa          , Aa          , Aa          , Aa          , Rr          , Rr          , Ch          , Ch          , Ch          , Ch          , Aa          , Ha          , Ha          
Ms          , Ha          , Aa          , 7 Kh        , Ch          , Ch          , Aa          , Rr          , Aa^Vla      , Aa          , Aa          , Aa          , Aa^Fpa      , Aa^Fpa      , Ha^Fpa      , Aa^Fpa      , Aa^Fpa      , Aa          , Aa^Fpa      , Aa^Fpa      , Ha^Fpa      , Aa^Fpa      , Aa^Fpa      , Aa^Fpa      , Aa^Fpa      , Aa          , Aa          , Aa^Vla      , Aa          , Rr          , Ch          , Ch          , 8 Kh        , Aa          , Ha          , Ha          
Ms          , Ha          , Ha          , Aa          , Ha          , Aa          , Ha          , Aa          , Ha          , Aa          , Ha^Fpa      , Ha^Fpa      , Ha^Fpa      , Ha^Fpa      , Ha^Fpa      , Ha^Fpa      , Aa^Fpa      , Aa^Fpa      , Ha^Fpa      , Ha^Fpa      , Ha^Fpa      , Ha^Fpa      , Ha^Fpa      , Ha^Fpa      , Ha^Fpa      , Aa^Fma      , Ha^Fpa      , Aa          , Ha          , Aa          , Ha          , Ch          , Ha          , Aa          , Ha          , Ms          
Ms          , Ms          , Ms          , Ha          , Ms          , Ha          , Ms          , Ha          , Ms          , Ha          , Aa^Fpa      , Ha^Fpa      , Aa^Fpa      , Ha^Fpa      , Ai          , Ai          , Ai          , Ha^Fpa      , Ha^Fpa      , Ha^Fpa      , Ai          , Ai          , Ai          , Ha^Fpa      , Aa^Fpa      , Ha^Fpa      , Aa^Fpa      , Ha          , Ms          , Ha          , Ms          , Ha          , Ms          , Ha          , Ms          , Ms          
Ms          , Ms          , Ms          , Ms          , Ms          , Ms          , Ms          , Ms          , Ms          , Ms          , Aa^Fpa      , Aa^Fpa      , Aa^Fpa      , Ha^Fpa      , Ai          , Ai          , Ai          , Ha^Fpa      , Ha^Fpa      , Ha^Fpa      , Ai          , Ai          , Ai          , Aa^Fpa      , Aa^Fpa      , Aa^Fpa      , Aa^Fpa      , Ms          , Ms          , Ms          , Ms          , Ms          , Ms          , Ms          , Ms          , Ms          
